################################################################
#..............................................................#
#..............................................................#
#....##########...............................................#
#....#........#...............................................#
#....#..####..#...............................................#
#....#..#..#..#...............................................#
#....#..#..#..#...............................................#
#....#..#..#..#########.......................................#
#....#..#..#..........#.......................................#
#....#..####..#####...#.......................................#
#....#........#...#...#.......................................#
#....##########...#...#.......................................#
#.................#...#.......................................#
#.................#...#.......................................#
#.................#####.......................................#
#..............................................................#
#....................S.........................................#
#..............................................................#
#..............................................................#
################################################################
